{
  "title": "chaotic_maze",
  "description": "Chaotic maze 30x30 map with dense narrow paths",
  "maxPlayers": 10,
  "map": {
    "width": 30,
    "height": 30,
    "tiles": [
    [0,0,2,0,3,0,3,0,0,0,0,0,3,0,3,0,2,0,0,0,0,0,3,0,3,0,3,0,0,0],
    [3,3,3,3,3,3,3,0,3,3,3,3,3,0,3,0,3,3,3,0,0,0,3,1,1,1,3,0,0,0],
    [0,3,3,3,3,0,3,3,3,0,0,0,3,3,3,3,3,0,3,0,0,0,3,0,0,0,3,0,0,0],
    [0,0,3,0,0,0,3,0,3,0,0,0,3,0,0,0,3,0,3,3,3,1,3,3,3,3,3,3,3,0],
    [0,0,3,0,0,0,3,3,3,0,0,0,3,0,0,0,3,0,0,3,0,0,3,0,0,0,3,0,1,0],
    [0,0,3,3,3,3,3,0,3,3,0,0,3,0,0,0,3,1,3,3,0,0,3,0,0,0,3,0,1,1],
    [3,3,3,0,0,0,1,0,3,3,0,0,1,3,3,3,3,0,0,3,3,3,3,3,3,0,3,0,1,0],
    [0,3,0,0,3,3,1,0,3,3,3,3,3,0,0,0,3,0,0,0,3,0,0,0,3,0,3,0,1,0],
    [0,3,3,3,3,3,1,0,0,1,0,0,3,0,3,3,3,0,0,0,3,0,0,0,3,0,3,1,1,1],
    [0,3,0,0,3,0,3,0,0,3,0,0,3,3,3,0,3,0,3,3,3,3,3,3,3,3,3,0,0,0],
    [0,3,1,1,3,0,3,0,0,3,0,0,1,0,1,0,1,0,1,0,0,0,1,0,0,3,3,0,0,0],
    [3,3,3,0,3,0,3,3,3,3,0,0,3,3,3,3,3,3,3,0,0,0,1,0,0,0,3,0,0,0],
    [0,0,3,0,3,3,3,0,3,0,0,0,3,0,3,0,0,0,3,0,0,0,1,0,0,0,3,0,0,0],
    [0,0,3,0,3,0,0,0,3,0,0,0,3,0,3,0,3,3,3,3,3,3,3,3,3,3,3,3,3,3],
    [0,0,3,0,1,0,0,0,1,1,0,0,3,0,3,0,3,0,0,0,0,0,3,0,0,0,0,0,1,0],
    [2,3,3,3,3,0,1,1,1,1,1,0,3,3,3,0,3,3,3,3,3,3,3,0,0,0,0,0,1,0],
    [0,3,3,0,1,3,3,0,0,3,3,3,3,3,2,3,3,0,0,1,0,0,1,3,3,3,3,3,3,3],
    [0,0,3,0,0,0,3,0,0,3,0,0,0,0,0,0,3,0,0,3,0,0,0,0,1,0,1,0,0,0],
    [0,0,3,0,0,0,3,0,0,3,0,0,0,0,3,1,3,0,0,3,0,0,0,0,1,0,1,0,0,0],
    [0,0,1,0,0,0,3,0,0,3,0,0,0,0,3,0,0,0,3,3,3,3,3,0,1,0,1,0,0,0],
    [0,0,3,0,0,0,3,0,0,3,0,0,0,0,3,0,0,0,3,3,0,0,3,3,3,0,3,0,0,0],
    [3,3,3,3,3,1,3,0,0,3,1,3,3,3,3,3,3,1,3,0,0,0,3,0,3,3,3,0,0,0],
    [0,0,3,0,3,0,3,3,3,3,1,0,0,0,3,0,3,0,3,0,0,0,3,0,0,0,3,3,3,2],
    [0,0,3,0,3,0,0,0,0,0,1,0,0,0,3,0,3,0,3,3,3,3,3,3,3,3,3,0,3,0],
    [0,0,3,0,3,0,0,0,0,0,3,0,0,0,3,0,3,0,0,3,0,0,0,0,3,0,0,0,3,0],
    [0,0,3,0,3,3,3,0,0,3,3,3,3,1,3,1,3,0,0,3,0,0,0,0,3,0,0,0,3,0],
    [3,3,3,3,3,3,3,3,3,3,0,0,3,0,0,0,3,3,3,1,0,0,0,0,3,0,0,0,3,3],
    [0,0,3,0,0,0,3,0,0,3,0,0,3,0,0,0,3,0,0,3,3,3,3,0,3,0,0,0,3,0],
    [0,0,3,3,3,3,3,0,0,3,3,3,3,1,3,3,3,0,0,0,0,0,3,1,1,3,3,3,3,0],
    [0,0,0,2,0,3,0,0,0,2,0,0,3,0,3,0,0,0,0,0,0,0,3,0,0,0,3,0,0,0]
  ]
  },
  "npcs": [
    {
      "moving_event": "frame",
      "type": "random",
      "count": 1
    }
  ],
  "parcels": {
    "generation_event": "2s",
    "decading_event": "1s",
    "max": 5,
    "reward_avg": 30,
    "reward_variance": 10
  },
  "player": {
    "movement_duration": 50,
    "observation_distance": -1,
    "capacity": 5
  }
}