{
  "name": "24c1_4",
  "description": "Migrated from 24c1_4.js",
  "width": 25,
  "height": 25,
  "tiles": [
    [0,0,0,1,3,3,3,3,3,3,3,0,3,3,3,3,3,3,3,3,3,3,0,0,0],
    [0,0,1,3,3,3,3,3,3,3,3,0,3,3,3,3,3,3,3,3,3,3,3,0,0],
    [0,1,3,3,3,3,3,3,3,3,3,0,3,3,3,3,3,3,3,3,3,3,1,3,0],
    [1,3,3,3,3,3,3,3,3,3,3,0,3,3,3,3,3,3,3,3,3,3,3,3,3],
    [3,3,3,3,3,3,3,3,3,3,3,0,3,3,3,3,3,3,3,3,3,3,3,3,3],
    [3,3,3,3,3,3,3,3,3,3,3,0,3,3,3,3,3,3,3,3,3,3,3,3,3],
    [3,3,3,3,3,3,3,3,3,3,3,0,3,3,3,3,3,3,3,3,3,3,3,3,3],
    [3,3,3,3,3,3,3,3,3,3,3,3,3,3,3,3,3,3,3,3,3,3,3,3,3],
    [3,3,3,3,3,3,3,3,3,3,3,3,3,3,3,3,3,3,3,3,3,3,3,3,3],
    [3,3,3,3,3,3,3,3,3,3,3,2,3,3,3,3,3,3,3,3,3,3,3,3,3],
    [3,3,3,3,3,3,3,3,3,3,2,0,2,3,3,3,3,3,3,3,3,3,3,3,3],
    [3,3,3,3,3,3,3,3,3,2,0,0,0,2,3,3,3,3,3,3,3,3,3,3,3],
    [0,0,0,0,0,0,3,3,2,0,0,0,0,0,2,3,3,0,0,0,0,0,0,0,0],
    [3,3,3,3,3,3,3,3,3,2,0,0,0,2,3,3,3,3,3,3,3,3,3,3,3],
    [3,3,3,3,3,3,3,3,3,3,2,0,2,3,3,3,3,3,3,3,3,3,3,3,3],
    [3,3,3,3,3,3,3,3,3,3,3,2,3,3,3,3,3,3,3,3,3,3,3,3,3],
    [3,3,3,3,3,3,3,3,3,3,3,3,3,3,3,3,3,3,3,3,3,3,3,3,3],
    [3,3,3,3,3,3,3,3,3,3,3,3,3,3,3,3,3,3,3,3,3,3,3,3,3],
    [3,3,3,3,3,3,3,3,3,3,3,0,3,3,3,3,3,3,3,3,3,3,3,3,3],
    [3,3,3,3,3,3,3,3,3,3,3,0,3,3,3,3,3,3,3,3,3,3,3,3,3],
    [3,3,3,3,3,3,3,3,3,3,3,0,3,3,3,3,3,3,3,3,3,3,3,3,0],
    [1,3,3,3,3,3,3,3,3,3,3,0,3,3,3,3,3,3,3,3,3,3,3,0,0],
    [1,1,3,3,3,3,3,3,3,3,3,0,3,3,3,3,3,3,3,3,3,3,0,0,0],
    [0,1,1,3,3,3,3,3,3,3,3,0,3,3,3,3,3,3,3,3,3,0,0,0,0],
    [0,0,1,1,3,3,3,3,3,3,3,0,3,3,3,3,3,3,3,3,0,0,0,0,0]
  ]
}