{
  "name": "24c1_7",
  "description": "Migrated from 24c1_7.js",
  "width": 20,
  "height": 20,
  "tiles": [
    [0,0,0,0,0,0,0,0,0,0,0,0,0,0,0,0,0,0,0,0],
    [2,3,3,3,3,3,3,3,0,0,0,3,3,3,3,3,3,3,3,0],
    [2,3,3,3,3,3,3,3,0,0,0,3,3,3,3,3,3,3,3,0],
    [0,0,0,0,0,0,3,3,3,3,3,3,3,3,0,0,0,3,3,0],
    [0,0,0,0,0,0,3,3,3,3,3,3,3,3,0,0,0,3,3,0],
    [0,3,3,3,3,3,3,3,0,3,0,0,0,0,0,0,0,3,3,0],
    [0,3,3,3,3,3,3,3,0,3,3,3,3,0,3,3,3,3,3,0],
    [0,3,3,0,0,0,0,0,0,0,0,3,3,0,3,3,3,3,3,0],
    [0,3,3,3,3,3,3,0,3,3,3,3,3,0,3,3,0,0,0,0],
    [0,3,3,3,3,3,3,0,3,3,0,0,0,0,3,3,0,0,0,0],
    [0,0,0,0,0,3,3,0,3,3,3,0,0,0,3,3,0,0,0,0],
    [0,0,0,3,3,3,3,0,0,0,3,0,0,0,3,3,3,3,0,0],
    [0,0,0,3,3,3,3,0,0,3,3,3,0,0,3,3,3,3,0,0],
    [0,0,0,3,3,0,0,0,3,3,3,3,3,0,0,0,3,3,0,0],
    [0,0,0,3,3,0,0,3,3,3,3,3,3,3,0,0,3,3,0,0],
    [1,3,3,3,3,3,3,3,3,3,3,3,3,3,3,3,3,3,3,1],
    [1,3,3,3,3,3,3,3,3,3,3,3,3,3,3,3,3,3,3,1],
    [0,0,3,3,0,0,0,0,3,3,0,0,0,0,3,3,0,0,0,0],
    [0,0,3,3,0,0,0,0,3,3,0,0,0,0,3,3,0,0,0,0],
    [0,0,1,1,0,0,0,0,1,1,0,0,0,0,1,1,0,0,0,0]
  ]
}