{
  "name": "24c1_3",
  "description": "Migrated from 24c1_3.js",
  "width": 30,
  "height": 30,
  "tiles": [
    [0,0,0,0,0,0,3,3,3,3,3,3,3,3,0,0,0,0,0,0,0,3,3,1,3,3,3,0,0,0],
    [0,0,3,3,3,1,3,3,3,3,3,3,3,3,0,0,0,0,0,0,0,3,3,1,3,3,3,0,0,0],
    [0,0,3,3,3,1,3,3,3,0,0,0,3,3,0,0,3,3,3,3,3,3,3,0,0,3,3,3,3,3],
    [0,0,3,3,0,0,3,3,3,0,0,0,3,3,0,0,3,3,3,3,3,3,3,0,0,3,3,3,3,3],
    [0,0,1,1,0,0,3,3,3,3,0,0,2,2,0,0,2,2,2,0,0,0,0,0,0,0,0,0,3,3],
    [0,0,3,3,0,0,0,3,3,3,2,3,3,3,0,0,3,3,3,0,0,0,0,0,0,0,0,0,1,1],
    [0,3,3,3,0,0,0,0,3,3,2,3,3,3,3,3,3,3,3,2,3,3,3,0,0,0,0,0,3,3],
    [3,3,3,3,0,0,0,0,0,3,2,3,3,3,3,3,3,3,3,2,3,3,3,3,0,0,0,0,3,3],
    [3,3,3,3,3,0,0,0,0,0,0,0,3,3,3,3,3,0,0,0,0,3,3,3,3,3,3,3,3,3],
    [0,3,3,3,3,3,0,0,0,0,0,0,3,3,3,3,3,3,0,0,0,0,3,3,3,3,3,3,3,3],
    [0,0,3,3,3,3,3,0,0,0,0,0,3,3,3,3,3,3,3,0,0,0,0,0,0,0,0,0,0,0],
    [0,0,0,3,3,3,3,3,3,3,2,3,3,3,3,0,3,3,3,2,0,0,0,3,3,3,3,3,3,3],
    [0,0,0,0,3,3,3,3,3,3,2,3,3,3,3,0,0,3,2,3,3,0,3,3,3,3,3,3,3,3],
    [0,0,0,0,0,0,0,0,0,0,0,0,2,2,2,0,0,0,3,3,3,3,3,3,3,0,0,0,3,3],
    [0,0,0,0,0,0,0,0,0,0,0,0,3,3,3,0,0,0,0,3,3,3,3,3,0,0,0,0,1,1],
    [0,0,3,3,3,3,3,3,3,3,3,3,3,3,3,0,0,0,0,0,3,3,3,0,0,0,0,0,3,3],
    [0,0,3,3,3,3,3,3,3,3,3,3,3,3,3,3,0,0,0,1,3,3,0,0,0,0,0,3,3,3],
    [0,0,3,3,0,0,0,0,0,3,3,3,3,3,3,3,3,0,3,3,1,0,0,0,0,0,3,3,3,3],
    [0,0,1,1,0,0,0,0,0,3,3,0,0,0,3,3,3,3,3,3,0,0,0,0,0,3,3,3,3,0],
    [0,0,3,3,0,0,0,0,0,2,2,0,0,0,0,3,3,3,3,0,0,0,0,0,3,3,3,3,0,0],
    [0,0,3,3,0,0,0,0,0,3,3,0,0,0,3,3,3,3,0,0,0,0,0,3,3,3,3,3,0,0],
    [3,3,3,3,3,3,3,2,3,3,3,0,0,3,3,3,3,0,0,0,0,0,3,3,3,3,3,3,3,3],
    [3,3,3,3,3,3,3,2,3,3,3,3,3,2,3,3,0,0,0,0,0,3,3,3,3,3,3,3,3,3],
    [3,3,3,3,3,3,3,2,3,3,3,3,3,3,2,0,0,0,0,0,3,3,3,3,0,0,0,0,3,3],
    [1,1,0,0,0,0,0,0,3,3,3,3,3,3,0,0,0,0,0,3,3,3,3,3,0,0,0,0,3,3],
    [3,3,3,0,0,0,0,2,3,3,3,3,3,0,0,0,0,0,3,3,3,3,3,3,0,0,0,0,1,1],
    [3,3,3,3,0,0,3,3,2,3,3,3,3,0,0,0,0,2,3,3,0,0,3,3,0,0,0,0,3,3],
    [0,3,3,3,3,3,3,3,3,2,0,3,3,3,0,0,3,2,3,0,0,0,3,3,0,0,0,0,3,3],
    [0,0,3,3,3,3,3,3,0,0,0,0,3,3,3,3,3,2,0,0,0,0,3,3,3,1,3,3,3,3],
    [0,0,0,3,3,3,3,0,0,0,0,0,0,3,3,3,3,0,0,0,0,0,3,3,3,1,3,3,3,3]
  ]
}