{
  "name": "24c1_9",
  "description": "Migrated from 24c1_9.js",
  "width": 20,
  "height": 20,
  "tiles": [
    [2,2,2,0,0,0,0,0,0,0,0,0,0,0,0,0,0,1,1,1],
    [3,3,3,0,0,0,0,0,0,0,0,0,0,0,0,0,0,1,1,1],
    [3,3,3,0,0,0,0,0,0,0,0,0,0,0,0,0,0,1,1,1],
    [3,3,3,0,0,0,0,0,0,0,0,0,0,0,0,0,0,3,3,3],
    [3,3,3,0,0,0,0,0,0,0,0,0,0,0,0,0,0,3,3,3],
    [3,3,3,3,3,0,0,0,0,0,0,0,0,0,0,3,3,3,3,3],
    [3,3,3,3,3,3,3,3,3,3,3,3,3,3,3,3,3,3,3,3],
    [3,3,3,3,3,0,0,0,0,0,0,0,0,0,0,3,3,3,3,3],
    [3,3,3,0,0,0,0,0,0,0,0,0,0,0,0,0,0,3,3,3],
    [3,3,3,3,3,3,3,0,0,0,0,0,0,3,3,3,3,3,3,3],
    [3,3,3,3,3,3,3,3,3,3,3,3,3,3,3,3,3,3,3,3],
    [3,3,3,3,3,3,3,0,0,0,0,0,0,3,3,3,3,3,3,3],
    [3,3,3,0,0,0,0,0,0,0,0,0,0,0,0,0,0,3,3,3],
    [3,3,3,3,3,3,3,3,3,0,0,3,3,3,3,3,3,3,3,3],
    [3,3,3,3,3,3,3,3,3,3,3,3,3,3,3,3,3,3,3,3],
    [3,3,3,3,3,3,3,3,3,0,0,3,3,3,3,3,3,3,3,3],
    [3,3,3,0,0,0,0,0,0,0,0,0,0,0,0,0,0,3,3,3],
    [3,3,3,3,3,3,3,3,3,3,3,3,3,3,3,3,3,3,3,3],
    [3,3,3,3,3,3,3,3,3,3,3,3,3,3,3,3,3,3,3,3],
    [3,3,3,3,3,3,3,3,3,3,3,3,3,3,3,3,3,3,3,3]
  ]
}