{
  "name": "24c2_5",
  "description": "Migrated from 24c2_5.js",
  "width": 30,
  "height": 30,
  "tiles": [
    [1,3,3,3,3,3,3,3,3,3,3,3,3,3,1,3,3,3,3,3,3,3,3,3,3,3,3,3,3,1],
    [3,0,0,0,0,0,0,0,0,0,0,0,0,0,3,0,0,0,0,0,0,0,0,0,0,0,0,0,0,3],
    [3,0,1,3,3,3,3,3,3,3,3,3,3,3,1,3,3,3,3,3,3,3,3,3,3,3,3,1,0,3],
    [3,0,3,0,0,0,0,0,0,0,0,0,0,0,3,0,0,0,0,0,0,0,0,0,0,0,0,3,0,3],
    [3,0,3,0,3,3,3,3,3,3,3,3,3,3,3,3,3,3,3,3,3,3,3,3,3,3,0,3,0,3],
    [3,0,3,0,3,3,3,3,3,3,3,3,3,3,3,3,3,3,3,3,3,3,3,3,3,3,0,3,0,3],
    [3,0,3,0,3,3,0,0,0,0,0,0,0,0,0,0,0,0,0,0,0,0,3,0,3,3,0,3,0,3],
    [3,0,3,0,3,3,3,3,3,3,3,3,3,3,3,3,3,3,3,3,3,0,3,0,3,3,0,3,0,3],
    [3,0,3,0,3,3,0,0,0,0,0,0,0,0,0,0,0,0,0,0,3,0,3,0,3,3,0,3,0,3],
    [3,0,3,0,3,3,0,3,3,3,3,3,3,3,3,3,3,3,3,0,3,0,3,0,3,3,0,3,0,3],
    [3,0,3,0,3,3,0,3,0,0,0,0,0,0,0,0,0,0,3,0,3,0,3,0,3,3,0,3,0,3],
    [3,0,3,0,3,3,0,3,0,3,3,3,3,3,3,3,3,0,3,0,3,0,3,0,3,3,0,3,0,3],
    [3,0,3,0,3,3,0,3,0,3,0,0,0,0,0,0,3,0,3,0,3,0,3,0,3,3,0,3,0,3],
    [3,0,3,0,3,3,0,3,0,3,0,3,3,3,3,3,3,0,3,0,3,0,3,0,3,3,0,3,0,3],
    [1,3,1,3,3,3,0,3,0,3,0,3,0,3,2,2,3,0,3,0,3,0,3,0,3,3,0,1,3,1],
    [3,0,3,0,3,3,0,3,0,3,0,3,0,3,2,2,3,0,3,0,3,0,3,0,3,3,0,3,0,3],
    [3,0,3,0,3,3,0,3,0,3,0,3,0,3,3,3,3,3,3,0,3,0,3,0,3,3,0,3,0,3],
    [3,0,3,0,3,3,0,3,0,3,0,3,0,3,0,0,0,0,0,0,3,0,3,0,3,3,0,3,0,3],
    [3,0,3,0,3,3,0,3,0,3,0,3,0,3,3,3,3,3,3,3,3,0,3,0,3,3,0,3,0,3],
    [3,0,3,0,3,3,0,3,0,3,0,3,0,0,0,0,0,0,0,0,0,0,3,0,3,3,0,3,0,3],
    [3,0,3,0,3,3,0,3,0,3,0,3,3,3,3,3,3,3,3,3,3,3,3,0,3,3,0,3,0,3],
    [3,0,3,0,3,3,0,3,0,3,0,0,0,0,0,0,0,0,0,0,0,0,0,0,3,3,0,3,0,3],
    [3,0,3,0,3,3,0,3,0,3,3,3,3,3,3,3,3,3,3,3,3,3,3,3,3,3,0,3,0,3],
    [3,0,3,0,3,3,0,3,0,0,0,0,0,0,0,0,0,0,0,0,0,0,0,0,3,3,0,3,0,3],
    [3,0,3,0,3,3,3,3,3,3,3,3,3,3,3,3,3,3,3,3,3,3,3,3,3,3,0,3,0,3],
    [3,0,3,0,3,3,3,3,3,3,3,3,3,3,3,3,3,3,3,3,3,3,3,3,3,3,0,3,0,3],
    [3,0,3,0,0,0,0,0,0,0,0,0,0,0,3,0,0,0,0,0,0,0,0,0,0,0,0,3,0,3],
    [3,0,1,3,3,3,3,3,3,3,3,3,3,3,1,3,3,3,3,3,3,3,3,3,3,3,3,1,0,3],
    [3,0,0,0,0,0,0,0,0,0,0,0,0,0,3,0,0,0,0,0,0,0,0,0,0,0,0,0,0,3],
    [1,3,3,3,3,3,3,3,3,3,3,3,3,3,1,3,3,3,3,3,3,3,3,3,3,3,3,3,3,1]
  ]
}