{
  "name": "24c2_9",
  "description": "Migrated from 24c2_9.js",
  "width": 20,
  "height": 20,
  "tiles": [
    [2,2,2,0,0,0,0,0,0,0,0,0,0,0,0,0,0,3,3,1],
    [3,3,3,0,0,0,0,0,0,0,0,0,0,0,0,0,0,3,3,1],
    [3,3,3,0,0,0,0,0,0,0,0,0,0,0,0,0,0,3,3,1],
    [3,3,3,0,0,0,0,0,0,0,0,0,0,0,0,0,0,3,3,1],
    [3,3,3,0,0,0,0,0,0,0,0,0,0,0,0,0,0,3,3,1],
    [3,3,3,3,3,0,0,0,0,0,0,0,0,0,0,3,3,3,3,1],
    [3,3,3,3,3,3,3,3,3,3,3,3,3,3,3,3,3,3,3,1],
    [3,3,3,3,3,0,0,0,0,0,0,0,0,0,0,3,3,3,3,1],
    [3,3,3,0,0,0,0,0,0,0,0,0,0,0,0,0,0,3,3,1],
    [3,3,3,3,3,3,3,0,0,0,0,0,0,3,3,3,3,3,3,1],
    [3,3,3,3,3,3,3,3,3,3,3,3,3,3,3,3,3,3,3,1],
    [3,3,3,3,3,3,3,0,0,0,0,0,0,3,3,3,3,3,3,1],
    [3,3,3,0,0,0,0,0,0,0,0,0,0,0,0,0,0,3,3,1],
    [3,3,3,3,3,3,3,3,3,0,0,3,3,3,3,3,3,3,3,1],
    [3,3,3,3,3,3,3,3,3,3,3,3,3,3,3,3,3,3,3,1],
    [3,3,3,3,3,3,3,3,3,0,0,3,3,3,3,3,3,3,3,1],
    [3,3,3,0,0,0,0,0,0,0,0,0,0,0,0,0,0,3,3,1],
    [3,3,3,3,3,3,3,3,3,3,3,3,3,3,3,3,3,3,3,1],
    [3,3,3,3,3,3,3,3,3,3,3,3,3,3,3,3,3,3,3,1],
    [3,3,3,3,3,3,3,3,3,3,3,3,3,3,3,3,3,3,3,1]
  ]
}