{
  "name": "25c1_8",
  "description": "Migrated from 25c1_8.js",
  "width": 20,
  "height": 20,
  "tiles": [
    [0,0,0,0,0,2,2,2,0,0,0,0,0,0,0,0,0,0,0,0],
    [0,0,0,3,3,3,3,3,0,0,0,0,3,3,1,3,3,3,3,0],
    [0,0,0,3,0,3,3,3,0,0,0,0,3,0,0,0,3,0,3,0],
    [0,0,0,3,0,0,3,0,0,0,0,0,3,3,1,3,3,0,3,0],
    [0,0,0,3,0,0,3,0,3,3,3,0,3,0,0,0,0,0,3,0],
    [0,0,3,3,3,0,3,3,3,0,3,3,3,0,0,0,0,0,3,0],
    [0,0,3,0,3,0,0,0,3,3,3,0,0,0,3,3,1,3,3,0],
    [0,0,1,0,1,0,0,0,0,0,0,0,0,0,3,0,0,0,3,0],
    [0,0,3,0,3,0,0,0,0,0,0,0,0,0,3,3,1,3,3,0],
    [0,0,3,3,3,0,0,0,3,3,1,3,1,3,3,0,0,0,0,0],
    [0,0,0,3,0,0,0,0,3,0,0,0,0,0,3,0,0,0,0,0],
    [0,0,0,3,0,0,3,3,3,3,1,3,1,3,3,0,0,0,0,0],
    [0,0,3,3,3,0,3,0,0,0,0,0,0,0,0,0,0,0,0,0],
    [0,0,3,0,3,0,3,0,0,0,0,0,3,3,1,3,3,0,0,0],
    [0,0,1,0,1,0,3,0,0,0,0,0,3,0,0,0,3,0,0,0],
    [0,0,3,0,3,0,3,3,1,3,0,0,3,3,1,3,3,3,3,0],
    [0,0,3,3,3,0,3,0,0,3,0,0,3,0,0,0,0,0,3,0],
    [0,0,0,3,0,0,3,1,3,3,3,3,3,0,0,0,0,0,3,0],
    [0,0,0,3,0,0,0,0,0,0,0,0,0,0,2,2,2,0,3,0],
    [0,0,0,3,3,3,3,3,3,3,3,3,3,3,3,3,3,3,3,0]
  ]
}