{
  "name": "25c1_5",
  "description": "Migrated from 25c1_5.js",
  "width": 30,
  "height": 30,
  "tiles": [
    [0,0,2,0,3,0,1,0,0,0,0,0,1,0,3,0,2,0,0,0,0,0,1,0,1,0,1,0,0,0],
    [3,3,3,3,3,3,3,0,1,1,1,1,1,0,3,0,3,3,3,0,0,0,1,1,1,1,1,0,0,0],
    [0,3,3,3,3,0,1,1,1,0,0,0,3,3,3,3,3,0,3,0,0,0,1,0,0,0,1,0,0,0],
    [0,0,3,0,0,0,1,0,1,0,0,0,1,0,0,0,3,0,3,3,3,1,1,1,1,1,1,1,1,0],
    [0,0,3,0,0,0,1,1,1,0,0,0,1,0,0,0,3,0,0,1,0,0,1,0,0,0,1,0,1,0],
    [0,0,3,3,3,3,3,0,1,1,0,0,1,0,0,0,3,1,1,1,0,0,1,0,0,0,1,0,1,1],
    [3,3,3,0,0,0,1,0,1,1,0,0,1,1,1,1,1,0,0,1,1,1,1,1,1,0,1,0,1,0],
    [0,3,0,0,1,1,1,0,1,1,1,1,1,0,0,0,1,0,0,0,1,0,0,0,1,0,1,0,1,0],
    [0,3,1,1,1,1,1,0,0,1,0,0,1,0,1,1,1,0,0,0,1,0,0,0,1,0,1,1,1,1],
    [0,1,0,0,1,0,1,0,0,1,0,0,1,1,1,0,1,0,1,1,1,1,1,1,1,1,1,0,0,0],
    [0,1,1,1,1,0,1,0,0,1,0,0,1,0,1,0,1,0,1,0,0,0,1,0,0,1,1,0,0,0],
    [1,1,3,0,1,0,1,1,1,1,0,0,3,1,3,1,1,1,1,0,0,0,1,0,0,0,1,0,0,0],
    [0,0,3,0,1,1,1,0,1,0,0,0,3,0,3,0,0,0,1,0,0,0,1,0,0,0,1,0,0,0],
    [0,0,3,0,1,0,0,0,1,0,0,0,3,0,3,0,3,1,1,1,1,1,1,1,1,1,1,1,1,1],
    [0,0,3,0,1,0,0,0,1,1,0,0,3,0,3,0,3,0,0,0,0,0,1,0,0,0,0,0,1,0],
    [2,3,3,3,3,0,1,1,1,1,1,0,3,3,3,0,3,1,1,1,1,1,1,0,0,0,0,0,1,0],
    [0,3,3,0,1,1,1,0,0,1,3,3,3,3,2,3,3,0,0,1,0,0,1,1,1,1,1,1,1,1],
    [0,0,3,0,0,0,1,0,0,1,0,0,0,0,0,0,3,0,0,1,0,0,0,0,1,0,1,0,0,0],
    [0,0,3,0,0,0,1,0,0,1,0,0,0,0,1,1,3,0,0,1,0,0,0,0,1,0,1,0,0,0],
    [0,0,1,0,0,0,1,0,0,1,0,0,0,0,1,0,0,0,1,1,1,1,1,0,1,0,1,0,0,0],
    [0,0,1,0,0,0,1,0,0,1,0,0,0,0,1,0,0,0,1,1,0,0,1,1,1,0,3,0,0,0],
    [1,1,1,1,3,1,1,0,0,1,1,1,1,1,1,1,1,1,1,0,0,0,1,0,3,3,3,0,0,0],
    [0,0,1,0,3,0,1,1,1,1,1,0,0,0,1,0,1,0,1,0,0,0,1,0,0,0,3,3,3,2],
    [0,0,1,0,3,0,0,0,0,0,1,0,0,0,1,0,1,0,1,1,1,1,1,1,3,3,3,0,3,0],
    [0,0,3,0,3,0,0,0,0,0,3,0,0,0,1,0,1,0,0,1,0,0,0,0,1,0,0,0,3,0],
    [0,0,3,0,3,3,3,0,0,3,3,3,3,1,1,1,1,0,0,1,0,0,0,0,1,0,0,0,3,0],
    [3,3,3,3,3,3,3,3,3,3,0,0,3,0,0,0,1,1,1,1,0,0,0,0,1,0,0,0,3,3],
    [0,0,3,0,0,0,3,0,0,3,0,0,3,0,0,0,1,0,0,1,1,1,1,0,1,0,0,0,3,0],
    [0,0,3,3,3,3,3,0,0,3,3,3,3,1,1,1,1,0,0,0,0,0,1,1,1,3,3,3,3,0],
    [0,0,0,2,0,3,0,0,0,2,0,0,3,0,1,0,0,0,0,0,0,0,1,0,0,0,3,0,0,0]
  ]
}