{
  "name": "25c1_7",
  "description": "Migrated from 25c1_7.js",
  "width": 20,
  "height": 20,
  "tiles": [
    [0,0,0,0,0,0,0,0,0,0,0,0,0,0,0,0,0,0,0,0],
    [0,3,3,3,3,3,3,3,0,0,0,3,3,3,3,3,3,3,2,0],
    [0,3,3,3,3,3,3,3,0,0,0,3,3,3,3,3,3,3,2,0],
    [0,3,3,0,0,0,3,3,3,3,3,3,3,3,0,0,0,0,0,0],
    [0,3,3,0,0,0,3,3,3,3,3,3,3,3,0,0,0,0,0,0],
    [0,3,3,0,0,0,0,0,0,3,0,0,0,0,0,0,0,0,0,0],
    [0,3,3,0,0,0,0,0,0,3,3,3,3,0,0,0,0,0,0,0],
    [0,3,3,0,0,0,0,0,0,0,0,3,3,0,0,0,0,0,0,0],
    [0,3,3,3,3,3,3,0,3,3,3,3,3,0,0,0,0,0,0,0],
    [0,3,3,3,3,3,3,0,3,3,0,0,0,0,0,0,0,0,0,0],
    [0,0,0,0,0,3,3,0,3,3,3,0,0,0,0,0,0,0,0,0],
    [0,0,0,3,3,3,3,0,0,0,3,0,0,0,0,0,0,0,0,0],
    [0,0,0,3,3,3,3,0,0,3,3,3,0,0,0,0,0,0,0,0],
    [0,0,0,3,3,0,0,0,3,3,3,3,3,0,0,0,3,3,0,0],
    [0,0,0,3,3,0,0,3,3,3,3,3,3,3,0,0,3,3,0,0],
    [1,3,3,3,3,3,3,3,3,3,3,3,3,3,3,3,3,3,3,1],
    [1,3,3,3,3,3,3,3,3,3,3,3,3,3,3,3,3,3,3,1],
    [0,0,3,3,0,0,0,0,3,3,0,0,0,0,3,3,0,0,0,0],
    [0,0,3,3,0,0,0,0,3,3,0,0,0,0,3,3,0,0,0,0],
    [0,0,1,1,0,0,0,0,1,1,0,0,0,0,1,1,0,0,0,0]
  ]
}