{
  "name": "25c1_9",
  "description": "Migrated from 25c1_9.js",
  "width": 20,
  "height": 20,
  "tiles": [
    [2,3,2,0,0,0,0,0,0,0,0,0,0,0,0,0,0,1,3,1],
    [3,2,3,0,0,0,0,0,0,0,0,0,0,0,0,0,0,3,1,3],
    [2,3,2,0,0,0,0,0,0,0,0,0,0,0,0,0,0,1,3,1],
    [3,2,3,0,0,0,0,0,0,0,0,0,0,0,0,0,0,3,1,3],
    [2,3,2,0,0,0,0,0,0,0,0,0,0,0,0,0,0,1,3,1],
    [3,2,3,3,3,0,0,0,0,0,0,0,0,0,0,3,1,3,1,3],
    [3,3,3,3,3,3,3,3,3,3,3,3,3,3,3,3,3,1,3,1],
    [3,3,3,3,3,0,0,0,0,0,0,0,0,0,0,3,1,3,1,3],
    [3,3,3,0,0,0,0,0,0,0,0,0,0,0,0,0,0,3,3,3],
    [3,3,3,3,3,3,3,0,0,0,0,0,0,3,3,3,3,3,3,3],
    [3,3,3,3,3,3,3,3,3,3,3,3,3,3,3,3,3,3,3,3],
    [3,3,3,3,3,3,3,0,0,0,0,0,0,3,3,3,3,3,3,3],
    [3,3,3,0,0,0,0,0,0,0,0,0,0,0,0,0,0,3,3,3],
    [3,3,3,3,3,3,3,3,3,0,0,3,3,3,3,3,3,3,3,3],
    [3,3,3,3,3,3,3,3,3,3,3,3,3,3,3,3,3,3,3,3],
    [3,3,3,3,3,3,3,3,3,0,0,3,3,3,3,3,3,3,3,3],
    [3,3,3,0,0,0,0,0,0,0,0,0,0,0,0,0,0,3,3,3],
    [3,3,3,3,3,3,3,3,3,3,3,3,3,3,3,3,3,3,3,3],
    [3,3,3,3,3,3,3,3,3,3,3,3,3,3,3,3,3,3,3,3],
    [3,3,3,3,3,3,3,3,3,3,3,3,3,3,3,3,3,3,3,3]
  ]
}