{
  "name": "25c2_9",
  "description": "Migrated from 25c2_9.js",
  "width": 30,
  "height": 30,
  "tiles": [
    [1,3,3,3,3,3,3,3,3,3,3,3,3,2,2,2,3,3,3,3,3,3,3,3,3,3,3,3,3,1],
    [0,0,0,0,0,0,0,0,0,0,0,0,0,2,0,2,0,0,0,0,0,0,0,0,0,0,0,0,0,0],
    [1,3,3,3,3,3,3,3,3,3,3,3,3,2,0,2,3,3,3,3,3,3,3,3,3,3,3,3,3,1],
    [0,0,0,0,0,0,0,0,0,0,0,0,0,2,0,2,0,0,0,0,0,0,0,0,0,0,0,0,0,0],
    [1,3,3,3,3,3,3,3,3,3,3,3,3,2,0,2,3,3,3,3,3,3,3,3,3,3,3,3,3,1],
    [0,0,0,0,0,0,0,0,0,0,0,0,0,2,0,2,0,0,0,0,0,0,0,0,0,0,0,0,0,0],
    [1,3,3,3,3,3,3,3,3,3,3,3,3,2,0,2,3,3,3,3,3,3,3,3,3,3,3,3,3,1],
    [0,0,0,0,0,0,0,0,0,0,0,0,0,2,0,2,0,0,0,0,0,0,0,0,0,0,0,0,0,0],
    [1,3,3,3,3,3,3,3,3,3,3,3,3,2,0,2,3,3,3,3,3,3,3,3,3,3,3,3,3,1],
    [0,0,0,0,0,0,0,0,0,0,0,0,0,2,0,2,0,0,0,0,0,0,0,0,0,0,0,0,0,0],
    [1,3,3,3,3,3,3,3,3,3,3,3,3,2,0,2,3,3,3,3,3,3,3,3,3,3,3,3,3,1],
    [0,0,0,0,0,0,0,0,0,0,0,0,0,2,0,2,0,0,0,0,0,0,0,0,0,0,0,0,0,0],
    [1,3,3,3,3,3,3,3,3,3,3,3,3,2,0,2,3,3,3,3,3,3,3,3,3,3,3,3,3,1],
    [0,0,0,0,0,0,0,0,0,0,0,0,0,2,0,2,0,0,0,0,0,0,0,0,0,0,0,0,0,0],
    [1,3,3,3,3,3,3,3,3,3,3,3,3,2,0,2,3,3,3,3,3,3,3,3,3,3,3,3,3,1],
    [0,0,0,0,0,0,0,0,0,0,0,0,0,2,0,2,0,0,0,0,0,0,0,0,0,0,0,0,0,0],
    [1,3,3,3,3,3,3,3,3,3,3,3,3,2,0,2,3,3,3,3,3,3,3,3,3,3,3,3,3,1],
    [0,0,0,0,0,0,0,0,0,0,0,0,0,2,0,2,0,0,0,0,0,0,0,0,0,0,0,0,0,0],
    [1,3,3,3,3,3,3,3,3,3,3,3,3,2,0,2,3,3,3,3,3,3,3,3,3,3,3,3,3,1],
    [0,0,0,0,0,0,0,0,0,0,0,0,0,2,0,2,0,0,0,0,0,0,0,0,0,0,0,0,0,0],
    [1,3,3,3,3,3,3,3,3,3,3,3,3,2,0,2,3,3,3,3,3,3,3,3,3,3,3,3,3,1],
    [0,0,0,0,0,0,0,0,0,0,0,0,0,2,0,2,0,0,0,0,0,0,0,0,0,0,0,0,0,0],
    [1,3,3,3,3,3,3,3,3,3,3,3,3,2,0,2,3,3,3,3,3,3,3,3,3,3,3,3,3,1],
    [0,0,0,0,0,0,0,0,0,0,0,0,0,2,0,2,0,0,0,0,0,0,0,0,0,0,0,0,0,0],
    [1,3,3,3,3,3,3,3,3,3,3,3,3,2,0,2,3,3,3,3,3,3,3,3,3,3,3,3,3,1],
    [0,0,0,0,0,0,0,0,0,0,0,0,0,2,0,2,0,0,0,0,0,0,0,0,0,0,0,0,0,0],
    [1,3,3,3,3,3,3,3,3,3,3,3,3,2,0,2,3,3,3,3,3,3,3,3,3,3,3,3,3,1],
    [0,0,0,0,0,0,0,0,0,0,0,0,0,2,0,2,0,0,0,0,0,0,0,0,0,0,0,0,0,0],
    [1,3,3,3,3,3,3,3,3,3,3,3,3,2,2,2,3,3,3,3,3,3,3,3,3,3,3,3,3,1],
    [0,0,0,0,0,0,0,0,0,0,0,0,0,0,0,0,0,0,0,0,0,0,0,0,0,0,0,0,0,0]
  ]
}