{
  "name": "25c2_7",
  "description": "Migrated from 25c2_7.js",
  "width": 30,
  "height": 30,
  "tiles": [
    [0,0,0,0,0,0,0,0,0,0,0,0,0,0,0,0,3,3,3,3,3,3,3,3,3,3,3,3,1,1],
    [0,0,0,0,0,0,0,0,0,0,0,0,0,0,3,3,3,3,3,3,3,3,3,3,3,3,3,3,1,1],
    [0,0,0,0,0,0,0,0,0,0,0,0,3,3,3,3,3,3,3,3,3,3,3,3,3,3,3,3,3,3],
    [0,0,0,0,0,0,0,0,0,0,0,3,3,3,3,3,3,3,3,3,3,3,3,3,3,3,3,3,3,3],
    [0,0,0,0,0,0,0,0,0,0,3,3,3,3,3,3,3,3,3,3,3,3,3,3,3,3,3,3,3,3],
    [0,0,0,0,0,0,0,0,0,3,3,3,3,3,3,3,3,0,0,3,3,3,3,3,3,3,3,3,3,3],
    [0,0,0,0,0,0,0,0,3,3,3,3,3,3,3,3,3,0,0,0,3,3,3,3,3,3,3,3,3,3],
    [0,0,0,0,0,0,0,3,3,3,3,3,3,3,3,3,3,0,0,0,0,0,3,3,3,3,3,3,3,0],
    [0,0,0,0,0,0,3,3,3,3,3,3,3,3,3,3,3,3,0,0,0,0,0,0,3,3,3,3,3,0],
    [0,0,0,0,0,3,3,3,3,3,3,3,3,3,3,3,3,3,0,0,0,0,0,0,0,3,3,3,0,0],
    [0,0,0,0,3,3,3,3,3,3,3,3,3,3,3,3,3,3,0,0,0,0,0,0,0,3,3,3,0,0],
    [0,0,0,3,3,3,3,3,3,3,3,3,3,3,3,3,3,3,0,0,0,0,0,0,3,3,3,0,0,0],
    [0,0,3,3,3,3,3,3,3,3,3,3,3,3,3,3,3,3,0,0,0,0,0,3,3,3,3,0,0,0],
    [0,3,3,3,3,3,3,3,3,3,3,3,3,3,3,3,3,3,0,0,0,0,0,3,3,3,3,0,0,0],
    [0,3,3,3,3,3,3,3,3,3,3,3,3,3,2,3,3,3,0,0,0,0,3,3,3,3,0,0,0,0],
    [3,3,3,3,0,3,3,3,3,3,3,3,3,3,3,3,3,3,3,0,0,0,3,3,3,3,0,0,0,0],
    [3,3,3,3,0,0,0,3,3,3,3,3,3,3,3,3,3,3,3,0,0,3,3,3,3,0,0,0,0,0],
    [3,3,3,0,0,0,0,0,0,3,3,3,3,3,3,3,3,3,3,0,0,3,3,3,3,0,0,0,0,0],
    [3,3,3,0,0,0,0,0,0,0,0,3,3,3,3,3,3,3,3,0,0,3,3,3,3,0,0,0,0,0],
    [3,3,3,0,0,0,0,0,0,0,0,0,0,3,3,3,3,3,3,0,3,3,3,3,0,0,0,0,0,0],
    [3,3,3,0,0,0,0,0,0,0,0,0,0,0,0,3,3,3,3,3,3,3,3,3,0,0,0,0,0,0],
    [3,3,0,0,0,0,0,0,0,0,0,0,0,0,0,0,3,3,3,3,3,3,3,0,0,0,0,0,0,0],
    [3,3,0,0,0,0,0,0,0,0,0,0,0,3,3,3,3,3,3,3,3,3,3,0,0,0,0,0,0,0],
    [3,3,0,0,0,0,0,0,0,0,3,3,3,3,3,3,3,3,3,3,3,3,0,0,0,0,0,0,0,0],
    [3,3,0,0,0,0,0,0,3,3,3,3,3,3,3,3,3,3,3,3,3,3,0,0,0,0,0,0,0,0],
    [3,3,0,0,0,3,3,3,3,3,3,3,3,3,3,3,3,3,3,3,3,3,0,0,0,0,0,0,0,0],
    [3,3,3,3,3,3,3,3,3,3,3,3,3,3,3,3,3,3,3,3,3,0,0,0,0,0,0,0,0,0],
    [3,3,3,3,3,3,3,3,3,3,3,3,3,3,3,3,3,3,3,3,3,0,0,0,0,0,0,0,0,0],
    [3,3,3,3,3,3,3,3,3,3,3,3,3,3,3,3,3,3,3,3,3,0,0,0,0,0,0,0,0,0],
    [1,3,3,3,3,3,3,3,3,3,3,3,3,3,3,3,3,3,3,3,0,0,0,0,0,0,0,0,0,0]
  ]
}