{
  "name": "challenge_23",
  "description": "Migrated from challenge_23.js",
  "width": 20,
  "height": 20,
  "tiles": [
    [0,0,0,0,0,0,2,0,0,0,0,0,2,0,0,0,0,0,0,0],
    [2,1,1,1,1,1,1,0,0,0,0,0,1,1,1,1,1,0,0,0],
    [0,0,1,0,0,0,1,1,1,1,1,1,1,0,0,0,1,0,0,0],
    [0,0,1,0,0,0,1,0,0,0,0,0,1,0,0,0,1,1,1,2],
    [0,0,1,0,0,0,1,0,0,0,0,0,1,0,0,0,1,0,0,0],
    [2,1,1,1,1,1,1,0,0,1,1,1,1,0,0,0,1,0,0,0],
    [0,1,0,0,0,0,1,1,1,1,0,0,1,1,1,1,1,1,1,2],
    [0,1,0,0,0,0,1,0,0,1,0,0,1,0,0,0,1,0,0,0],
    [0,1,1,1,1,1,1,0,0,1,0,0,1,0,0,0,1,0,0,0],
    [0,1,0,0,1,0,1,0,0,1,0,0,1,1,1,1,1,1,1,0],
    [0,1,0,0,1,0,1,0,0,1,0,0,1,0,1,0,0,0,1,0],
    [2,1,1,1,1,0,1,1,1,1,1,1,1,0,1,0,0,0,1,0],
    [0,0,1,0,0,0,1,0,1,0,0,0,1,0,1,0,0,0,1,0],
    [0,0,1,0,0,0,1,0,1,0,0,0,1,0,1,0,1,1,1,2],
    [0,0,1,0,0,0,1,0,1,0,0,0,1,0,1,1,1,0,0,0],
    [2,1,1,1,1,1,1,0,1,1,1,1,1,0,0,0,1,0,0,0],
    [0,0,1,0,0,0,1,0,0,1,0,0,1,1,1,1,1,1,1,2],
    [0,0,1,0,0,0,1,1,1,1,0,0,1,0,0,0,1,0,0,0],
    [0,0,1,0,0,0,1,0,0,1,0,0,1,0,0,0,1,0,0,0],
    [0,0,2,0,0,0,2,0,0,2,0,0,2,0,0,0,2,0,0,0]
  ]
}