{
  "name": "challenge_32",
  "description": "Migrated from challenge_32.js",
  "width": 20,
  "height": 20,
  "tiles": [
    [1,3,3,3,3,3,3,3,3,3,3,3,3,3,3,3,3,3,3,2],
    [0,0,0,0,0,0,0,0,0,0,0,0,0,0,0,0,0,0,0,0],
    [1,3,3,3,3,3,3,3,3,3,3,3,3,3,3,3,3,3,3,2],
    [0,0,0,0,0,0,0,0,0,0,0,0,0,0,0,0,0,0,0,0],
    [1,3,3,3,3,3,3,3,3,3,3,3,3,3,3,3,3,3,3,2],
    [0,0,0,0,0,0,0,0,0,0,0,0,0,0,0,0,0,0,0,0],
    [1,3,3,3,3,3,3,3,3,3,3,3,3,3,3,3,3,3,3,2],
    [0,0,0,0,0,0,0,0,0,0,0,0,0,0,0,0,0,0,0,0],
    [1,3,3,3,3,3,3,3,3,3,3,3,3,3,3,3,3,3,3,2],
    [0,0,0,0,0,0,0,0,0,0,0,0,0,0,0,0,0,0,0,0],
    [1,3,3,3,3,3,3,3,3,3,3,3,3,3,3,3,3,3,3,2],
    [0,0,0,0,0,0,0,0,0,0,0,0,0,0,0,0,0,0,0,0],
    [1,3,3,3,3,3,3,3,3,3,3,3,3,3,3,3,3,3,3,2],
    [0,0,0,0,0,0,0,0,0,0,0,0,0,0,0,0,0,0,0,0],
    [1,3,3,3,3,3,3,3,3,3,3,3,3,3,3,3,3,3,3,2],
    [0,0,0,0,0,0,0,0,0,0,0,0,0,0,0,0,0,0,0,0],
    [1,3,3,3,3,3,3,3,3,3,3,3,3,3,3,3,3,3,3,2],
    [0,0,0,0,0,0,0,0,0,0,0,0,0,0,0,0,0,0,0,0],
    [1,3,3,3,3,3,3,3,3,3,3,3,3,3,3,3,3,3,3,2],
    [0,0,0,0,0,0,0,0,0,0,0,0,0,0,0,0,0,0,0,0]
  ]
}