{
  "name": "challenge_31",
  "description": "Migrated from challenge_31.js",
  "width": 20,
  "height": 20,
  "tiles": [
    [1,3,3,3,3,3,3,3,3,3,3,3,3,3,3,3,3,3,3,1],
    [0,0,0,0,0,0,0,0,0,3,3,0,0,0,0,0,0,0,0,0],
    [1,3,3,3,3,3,3,3,3,3,3,3,3,3,3,3,3,3,3,1],
    [0,0,0,0,0,0,0,0,0,3,3,0,0,0,0,0,0,0,0,0],
    [1,3,3,3,3,3,3,3,3,3,3,3,3,3,3,3,3,3,3,1],
    [0,0,0,0,0,0,0,0,0,3,3,0,0,0,0,0,0,0,0,0],
    [1,3,3,3,3,3,3,3,3,3,3,3,3,3,3,3,3,3,3,1],
    [0,0,0,0,0,0,0,0,0,3,3,0,0,0,0,0,0,0,0,0],
    [2,3,3,3,3,3,3,3,3,3,3,3,3,3,3,3,3,3,3,2],
    [0,0,0,0,0,0,0,0,0,3,3,0,0,0,0,0,0,0,0,0],
    [1,3,3,3,3,3,3,3,3,3,3,3,3,3,3,3,3,3,3,1],
    [0,0,0,0,0,0,0,0,0,3,3,0,0,0,0,0,0,0,0,0],
    [1,3,3,3,3,3,3,3,3,3,3,3,3,3,3,3,3,3,3,1],
    [0,0,0,0,0,0,0,0,0,3,3,0,0,0,0,0,0,0,0,0],
    [1,3,3,3,3,3,3,3,3,3,3,3,3,3,3,3,3,3,3,1],
    [0,0,0,0,0,0,0,0,0,3,3,0,0,0,0,0,0,0,0,0],
    [1,3,3,3,3,3,3,3,3,3,3,3,3,3,3,3,3,3,3,1],
    [0,0,0,0,0,0,0,0,0,0,0,0,0,0,0,0,0,0,0,0],
    [0,0,0,0,0,0,0,0,0,0,0,0,0,0,0,0,0,0,0,0],
    [0,0,0,0,0,0,0,0,0,0,0,0,0,0,0,0,0,0,0,0]
  ]
}