{
  "name": "loops",
  "description": "Migrated from loops.js",
  "width": 20,
  "height": 20,
  "tiles": [
    [3,3,3,3,3,3,3,3,3,2,3,3,3,3,3,3,3,3,3,0],
    [3,0,0,0,0,0,0,0,0,0,0,0,0,0,0,0,0,0,3,0],
    [3,0,3,3,3,3,3,3,3,3,3,3,3,3,3,3,3,0,3,0],
    [3,0,3,0,0,0,0,0,0,0,0,0,0,0,0,0,3,0,3,0],
    [3,0,3,0,3,3,3,3,3,2,3,3,3,3,3,0,3,0,3,0],
    [3,0,1,0,3,0,0,0,0,0,0,0,0,0,3,0,3,0,3,0],
    [3,0,3,0,3,0,3,3,3,3,3,3,3,0,3,0,1,0,3,0],
    [3,0,3,0,3,0,3,0,0,0,0,0,3,0,3,0,3,0,3,0],
    [3,0,3,0,3,0,1,0,0,0,0,0,1,0,3,0,3,0,3,0],
    [3,0,3,0,3,0,3,0,0,0,0,0,3,0,3,0,3,0,3,0],
    [3,0,3,0,3,0,3,0,0,0,0,0,3,0,3,0,3,0,3,0],
    [3,0,3,0,3,0,3,0,0,0,0,0,3,0,3,0,3,0,3,0],
    [3,0,3,0,1,0,3,0,0,0,0,0,3,0,1,0,3,0,3,0],
    [3,0,3,0,3,0,3,3,3,2,3,3,3,0,3,0,3,0,3,0],
    [3,0,3,0,3,0,0,0,0,0,0,0,0,0,3,0,3,0,3,0],
    [1,0,3,0,3,3,3,3,3,3,3,3,3,3,3,0,3,0,1,0],
    [3,0,3,0,0,0,0,0,0,0,0,0,0,0,0,0,3,0,3,0],
    [3,0,3,3,3,3,3,3,3,2,3,3,3,3,3,3,3,0,3,0],
    [3,0,0,0,0,0,0,0,0,0,0,0,0,0,0,0,0,0,3,0],
    [3,3,3,3,3,3,3,3,3,3,3,3,3,3,3,3,3,3,3,0]
  ]
}