{
  "name": "map_20",
  "description": "Migrated from map_20.js",
  "width": 20,
  "height": 20,
  "tiles": [
    [0,0,1,0,1,0,2,0,0,0,0,0,1,0,2,0,1,0,0,0],
    [2,1,1,1,1,1,1,1,1,1,1,1,1,1,1,1,1,1,1,1],
    [0,0,1,0,1,0,1,0,1,0,0,0,1,0,1,0,1,0,1,0],
    [0,0,1,0,1,0,1,0,1,1,0,0,1,0,1,0,1,0,1,1],
    [0,0,1,0,1,0,1,0,0,1,0,0,1,0,1,0,1,0,0,0],
    [1,1,1,1,1,1,1,1,1,1,1,1,1,1,1,1,1,1,1,1],
    [2,1,1,1,1,1,1,1,1,1,1,1,1,1,1,1,1,1,1,2],
    [0,0,1,0,0,0,1,0,0,1,0,0,1,0,0,0,1,0,0,0],
    [0,0,1,0,1,1,1,0,0,1,0,0,1,0,1,1,1,0,0,0],
    [0,0,1,1,1,0,1,0,0,2,0,0,1,1,1,0,1,0,0,0],
    [0,0,1,0,1,0,1,0,0,1,0,0,1,0,1,0,1,0,0,0],
    [2,1,1,1,1,1,1,1,1,1,1,1,1,1,1,1,1,1,1,1],
    [0,0,1,0,1,0,1,0,1,0,0,0,1,0,1,0,1,0,1,0],
    [0,0,1,0,1,0,1,0,1,1,0,0,1,0,1,0,1,0,1,2],
    [0,0,1,0,1,0,1,0,0,1,0,0,1,0,1,0,1,0,0,0],
    [1,1,1,1,1,1,1,1,1,1,1,1,1,1,1,1,1,1,1,1],
    [1,1,1,1,1,1,1,1,1,1,1,1,1,1,1,1,1,1,1,1],
    [0,0,1,0,0,0,1,0,0,1,0,0,1,0,0,0,1,0,0,0],
    [0,0,1,0,1,1,1,0,0,1,0,0,1,0,1,1,1,0,0,0],
    [0,0,2,0,1,0,0,0,0,2,0,0,1,0,2,0,0,0,0,0]
  ]
}